12 9
OOOOOOOOOOOO
OS  0L   OOO
OO OO OO OOO
OO OOOOO OOO
OOL0 +  LOOO
OO OOOOO0OOO
OO OO OO OOO
OO  0R  R0FO
OOOOOOOOOOOO
OOOOOOOOOOOO