12 8
OOOOOOOOOOOO
OOOOOOOOOOOO
OS   L0 R0OO
OO OO OO OOO
OO OO0OO OOO
OO   R  L0FO
OOOOOOOOOOOO
OOOOOOOOOOOO