49 14
OOOOOOOOOOOOOOOOOOOOOOOOOOOOOOOOOOOOOOOOOOOOOOOOO
OOOOOOOOOOOOOOOOOOOOOOOOOOOOOOOOOOOOOOOOOOOOOOOOO
OOS   L0           O    L0       R0 R0    R0  FOO
OOO OO OO OO OO OO OO OO OO OO OO OO OOOOO OOOOOO
OOO OO OO0OOOOO OO OOOOO OO OO OO OO OOOOOOOO OOO
OOO OOL  L  +    O   +    O+OO+OO+O R0 L  +   OOO
OO0ROO0OOOOOOOO OO OOOOO OO OO OO OOOOO0OOOOO OOO
OOO OOOOO OOOOOOOO OO OOOOO0OO OO OOOOOOOOOOO0OOO
OOO   +     +       O   +  R 0ROOR00L  L  +  LOOO
OOO OOOOO OOOOOOOO OOOOOOOOOOO OO OO OO0OOOOO OOO
OOO OO0OO OO OO OO0OO OO OOOOO OO OO OO0OO OO OOO
OOO   L   O       L                  O R      OOO
OOOOOOOOOOOOOOOOOOOOOOOOOOOOOOOOOOOOOOOOOOOOOOOOO
OOOOOOOOOOOOOOOOOOOOOOOOOOOOOOOOOOOOOOOOOOOOOOOOO