15 14
OOOOOOOOOOOOOOO
OOOOOOOOOOOOOOO
OS   L      OOO
OO OO0OO OO OOO
OO OOOOOOOO OOO
OO   +  +  ROOO
OO OO OO OO0OOO
OO OOOOOOOO OOO
OOR  +  +  ROOO
OO0OOOOOOOO0OOO
OO OO OO OO OOO
OO      R0 R0FO
OOOOOOOOOOOOOOO
OOOOOOOOOOOOOOO