18 22
OOOOOOOOOOFOOOOOOO
O    OOOOO OO    O
O OO OOOOO OO OO O
O OOOOOOOOOOO OO O
O   +     + O+O  O
OOOOOOOOOOOOO OOOO
OOOO OOOOO OO OOOO
O       OO    OOOO
O OO OO OOOOO OOOO
O OOOOO OOOOOOOOOO
O   + O+O    +   O
OOOOOOO OOOOOOOO O
OOOO OO OOOOO OO O
OOOO       OO OO O
OOOO OO OO OO OO O
OOOO OOOOO OOOOO O
O  O+O +     +   O
O OO OOOOOOOOOOOOO
O OO OO OOOOO OOOO
O             OOOO
OOOOSOOOOOOOOOOOOO
OOOOOOOOOOOOOOOOOO